11111111111111111111
101010000000000000E1
1100000000C000000001
111P0000000000110001
10000000000000000001
10000110001000000001
10000000000000000001
11111111111111111111