1111111111111111111111111111111111
10CCCCCCCCCCCCCCCCCCCCCCCCCCCCCCC1
1C111101111010000110011100E00110C1
1C100101000010001G01010010001001C1
1C100001000010001001010010101G01C1
1C100001111010001111010010101111C1
1C100001000010001P01010010101001C1
1C100101000010001001010010101001C1
1C111101111011101001011100101001C1
1CCCCCCCCCCCCCCCCCCCCCCCCCCCCCCCC1
1111111111111111111111111111111111