1111111
1P001G1
1000111
100C001
1110001
1G100E1
1111111