1111111
1P00101
1110101
101C101
1010101
10000E1
1111111
