111111111111111111111111111
1CCCCCCCCCCC111CCCCCCCCCCC1
1C1111C1111C111C1111C1111C1
1C1111C1111C111C1111C1111C1
1C1111C1111C111C1111C1111C1
1CCCCCCCCCCCCCCCCCCCCCCCCC1
1C1111C1C111111111C1C1111C1
1CCCCCC1CCCC111CCCC1CCCCCC1
111111C1111011101111C111111
111111C1000000000001C111111
111111C1011100011101C111111
11CCCCC0G100000001G0CCCCCE1
111111C1011111111101C111111
111111C1000000000001C111111
111111C1011111111101C111111
1CCCCCCCCCCC111CCCCCCCCCCC1
1C1111C1111C111C1111C1111C1
1CCC11CCCCCCCPCCCCCCC11CCC1
111C11C1C111111111C1C11C111
1CCCCCC1CCCC111CCCC1CCCCCC1
1C111111111C111C111111111C1
1CCCCCCCCCCCCCCCCCCCCCCCCC1
111111111111111111111111111