1111111111111111111111111111111111
1P000000000000000000000000000000C1
1011110111101000011001110010011001
1010010100001000100101001000100101
1010000100001000100101001010100101
1010000111101000111101001010111101
1010000100001000100101001010100101
1010010100001000100101001010100101
1011110111101110100101110010100101
1C000000000000000000000000000000E1
1111111111111111111111111111111111