11111111
1P0E10C1
11111111
1000G0G1
11111111