11111111
1P0E1001
10000001
11111111
