1111111111111
1000000000001
1011101011101
101E10101C101
1010001000101
1011111111101
1000000P00001
1011111111101
1010001000101
101C10101C101
1011101011101
1000000000001
1111111111111