1111111
1P001G1
1110101
101C101
1010101
1G000E1
1111111